btc - Bitcoin
eth - Ethereum
xrp - Ripple
bch - Bitcoin Cash
ltc - Litecoin
neo - NEO
ada - Cardano
xlm - Stellar
miota - IOTA
eos - EOS
dash - Dash
xmr - Monero
xem - NEM
usdt - Tether
trx - TRON
ven - VeChain
etc - Ethereum Classic
lsk - Lisk
btg - Bitcoin Gold
omg - OmiseGO
nano - Nano
qtum - Qtum
bnb - Binance Coin
zec - Zcash
icx - ICON
dgd - DigixDAO
ppt - Populous
bcn - Bytecoin
steem - Steem
waves - Waves
xvg - Verge
mkr - Maker
strat - Stratis
doge - Dogecoin
rhoc - RChain
bts - BitShares
dcr - Decred
sc - Siacoin
rep - Augur
ae - Aeternity
btm - Bytom
snt - Status
ont - Ontology
wtc - Waltonchain
zil - Zilliqa
kmd - Komodo
cnx - Cryptonex
ardr - Ardor
ark - Ark
aion - Aion
hsr - Hshare
zrx - 0x
veri - Veritaseum
mona - MonaCoin
fct - Factom
kcs - KuCoin Shares
dgb - DigiByte
pivx - PIVX
etn - Electroneum
bat - Basic Attention Token
r - Revain
sys - Syscoin
gnt - Golem
gas - Gas
qash - QASH
ethos - Ethos
lrc - Loopring
fun - FunFair
nas - Nebulas
drgn - Dragonchain
gxs - GXChain
xzc - ZCoin
emc - Emercoin
iost - IOStoken
dcn - Dentacoin
kin - Kin
elf - aelf
part - Particl
rdd - ReddCoin
knc - Kyber Network
nxt - Nxt
salt - SALT
smart - SmartCash
maid - MaidSafeCoin
link - ChainLink
